1111111111111
10010000001C1
10010000001C1
1001000000101
10010000000C1
1100011111001
1P0011E000001
1111111111111