1111111111111111111111111111111111
100000000000000C00001C0000E0000001
1010010100100000101011100000010101
1010010010101000001001000000010101
1P0000000C00C0000000000000000000C1
1111111111111111111111111111111111