1111111111111
10010000001C1
10010C00001C1
1001000000101
100100C0000C1
10010000000C1
10010000000C1
100100C0000C1
10010000000C1
10010000000C1
10010000000C1
1000011111001
1P0011E000001
1111111111111